ID,Name,Club,Rating,Played,Won,Lost,"Win %"
516,"Shaun Jones",Duinefontein,1542,14,14,0,100.0
330,"Theo Cogill","Community House",1514,12,12,0,100.0
364,"Nashwin Pienaar",Liv-Ken,1513,14,14,0,100.0
256,"Theo Lingeveldt",Boundary,1503,14,13,1,92.9
264,"Cuten Lodewyk","Community House",1495,19,16,3,84.2
533,"Rochica Sonday",Duinefontein,1486,16,14,2,87.5
147,"Moeneeb Isaacs","MP Royals",1478,14,11,3,78.6
244,"Musfiquh Kalam",Boundary,1472,18,16,2,88.9
688,"Isgaaq Jassiem",Stephanians,1470,14,13,1,92.9
242,"Denver Sweatz",Boundary,1460,14,11,3,78.6
560,"Ashlyn Wagner",Stephanians,1449,14,11,3,78.6
379,"Zahier Isaacs",Nexus,1446,14,11,3,78.6
424,"Kirshwan Steyn",Ravens,1444,14,11,3,78.6
347,"Darren Rodgers",Liv-Ken,1443,12,10,2,83.3
354,"Adrian Philander",Liv-Ken,1434,12,10,2,83.3
503,"Lindsay October",Duinefontein,1433,14,10,4,71.4
154,"Llewellyn Bartlett","MP Royals",1430,14,11,3,78.6
263,"Jodie Galant","Community House",1430,12,9,3,75.0
540,"Bernard Stewe",Goodwood,1429,12,10,2,83.3
485,"David Nwafor",Duinefontein,1428,14,10,4,71.4
561,"Yusuf Steyn",Stephanians,1424,14,10,4,71.4
289,"Emmanuel Uzoukwu","Community House",1421,14,12,2,85.7
173,"Errol Kannemeyer","MP Royals",1414,14,14,0,100.0
339,"Benjamin Vd Ross",Liv-Ken,1409,14,11,3,78.6
95,"Timothy Fitzgibbon",Top,1408,18,12,6,66.7
426,"Warren Julius",Ravens,1406,16,11,5,68.8
6,"Joshua Du Plooy",Ravens,1402,18,12,6,66.7
335,"Grant Bailey",Liv-Ken,1398,8,8,0,100.0
378,"Muaath Adams",Nexus,1396,14,10,4,71.4
294,"Mahdi Adams","Community House",1395,12,9,3,75.0
496,"Jerome Davies",Duinefontein,1395,12,8,4,66.7
189,"Alex Kleintjies","SP Saints",1393,12,11,1,91.7
545,"Daryl Williams",Goodwood,1392,14,9,5,64.3
519,"Wayden Brown",Duinefontein,1390,12,11,1,91.7
305,"Stephen Katzef","Community House",1386,14,11,3,78.6
340,"Derrel Adriaans",Liv-Ken,1384,14,10,4,71.4
194,"Carl Adams",Steenberg,1383,12,10,2,83.3
216,"Daylin May","Bishop Lavis",1383,16,12,4,75.0
195,"Gavern Africa",Steenberg,1379,12,10,2,83.3
514,"Samkele Notshe",Duinefontein,1379,12,10,2,83.3
258,"Rashaad Safodien",Boundary,1376,14,10,4,71.4
341,"Damian Jeftha",Liv-Ken,1376,12,10,2,83.3
180,"Garth Arenz","SP Saints",1375,14,12,2,85.7
333,"Munier Ferhelst",DLPE,1375,14,12,2,85.7
387,"Munier Isaacs",Nexus,1375,12,8,4,66.7
161,"Rashied Ismail","MP Royals",1374,14,11,3,78.6
343,"Ashley Wesson",Liv-Ken,1374,12,8,4,66.7
522,"Zakeer Moosa",Duinefontein,1370,10,6,4,60.0
164,"Llewellyn Paris","MP Royals",1368,14,11,3,78.6
182,"Jamie Louw","SP Saints",1368,14,12,2,85.7
594,"Dale Titus",Stephanians,1368,12,8,4,66.7
179,"Kevin Roodt","SP Saints",1367,14,10,4,71.4
857,"Shane Overmeyer",Kuilsriver,1364,12,11,1,91.7
196,"Lester Van Der Ross",Steenberg,1362,12,9,3,75.0
311,"Brandon Orderson","Community House",1362,14,11,3,78.6
183,"Ethan Meyer","SP Saints",1361,14,9,5,64.3
186,"Elroy Gabriel","SP Saints",1360,14,10,4,71.4
156,"Henry Arends","MP Royals",1359,12,9,3,75.0
695,"Caitlin Lingeveldt",Boundary,1359,14,8,6,57.1
564,"Clement Meyer",Stephanians,1358,10,9,1,90.0
98,"Keenen Jooste",Top,1352,8,4,4,50.0
155,"Kyle Martin","MP Royals",1351,8,6,2,75.0
233,"Zahier Mohamed","Bishop Lavis",1351,10,8,2,80.0
296,"Ronald Hutchinson","Community House",1349,14,9,5,64.3
382,"Craig Fortuin",Nexus,1349,12,8,4,66.7
397,"Sacha Davids",Nexus,1346,12,8,4,66.7
547,"Edward Hahn",Goodwood,1343,16,10,6,62.5
51,"Scelo Mkhetho",CPUT,1342,14,11,3,78.6
255,"Matthew Lingeveldt",Boundary,1341,14,8,6,57.1
266,"Jiyaad Kara","Community House",1341,8,6,2,75.0
246,"Tamika Van As",Boundary,1340,10,7,3,70.0
416,"Angeline Wood",Ravens,1339,14,10,4,71.4
207,"Nasr Esau",UWC,1337,12,10,2,83.3
227,"Yunus Moyce","Bishop Lavis",1337,12,8,4,66.7
372,"TJ Sabad",Nexus,1337,16,12,4,75.0
370,"Shahied Johaadien",Nexus,1336,10,8,2,80.0
284,"Anton Titus","Community House",1335,12,6,6,50.0
160,"Keenan Holt","MP Royals",1333,12,9,3,75.0
497,"Jonathan Mukwekwerere",Duinefontein,1330,8,6,2,75.0
166,"Ivor Arendse","MP Royals",1328,14,11,3,78.6
405,"William Reizenberg",Protea,1323,14,10,4,71.4
152,"Russel Jansen","MP Royals",1322,14,7,7,50.0
557,"Yusuf Rajie",Goodwood,1319,14,7,7,50.0
283,"Angelo Isaacs","Community House",1317,12,6,6,50.0
149,"Westley Mccloud","MP Royals",1315,14,5,9,35.7
386,"Riad Maneveld",Nexus,1315,14,9,5,64.3
556,"Yaseen Hassam",Goodwood,1313,16,11,5,68.8
192,"Stanley Prinsloo",Steenberg,1312,8,5,3,62.5
291,"Gavin Parsons","Community House",1312,14,8,6,57.1
392,"Saaliegh Jabaar",Nexus,1312,8,5,3,62.5
388,"Moenieb Roberts",Nexus,1309,12,8,4,66.7
422,"Frans Erasmus",Ravens,1308,14,6,8,42.9
104,"Gaston Koetaan",Top,1307,14,6,8,42.9
373,"Amien Phillips",Nexus,1307,16,11,5,68.8
377,"Ebrahiem Carr",Nexus,1305,8,7,1,87.5
211,"Marvin Makhubela",UWC,1303,12,9,3,75.0
100,"Chris Sloster",Top,1299,16,7,9,43.8
866,"Ismail Badat",Lenasia,1299,10,8,2,80.0
972,"Abdul Hay",Waterfall,1298,10,8,2,80.0
157,"Abubakr Manuel","MP Royals",1297,14,6,8,42.9
376,"Sabri De Sani",Nexus,1297,8,7,1,87.5
193,"Benadick Mentor",Steenberg,1296,12,7,5,58.3
420,"Demos Dracoulides",Ravens,1294,14,5,9,35.7
499,"Keanin Pekeur",Duinefontein,1293,12,4,8,33.3
205,"Matthew Meade",UWC,1291,10,7,3,70.0
106,"Allan Clark",Top,1290,14,6,8,42.9
165,"Riedewaan Hendricks","MP Royals",1290,8,6,2,75.0
300,"Tashreeq Baba","Community House",1290,16,7,9,43.8
105,"Rubin Willemse",Top,1288,16,7,9,43.8
577,"Terence Onrust",Stephanians,1288,10,6,4,60.0
2,"DJ Swanevelder",Maties,1286,11,8,3,72.7
79,"Logan Willemse",Top,1286,10,8,2,80.0
118,"Deon Swartz",Top,1285,12,9,3,75.0
381,"Martin Arnolds",Nexus,1284,10,6,4,60.0
150,"Walter Dreyer","MP Royals",1283,12,5,7,41.7
935,"Starn Hui",Rivonia,1280,11,8,3,72.7
176,"Bradley Van Aswegen","MP Royals",1279,12,5,7,41.7
111,"Victor Grabe",Top,1277,8,4,4,50.0
580,"Ameen Jansen",Stephanians,1275,14,6,8,42.9
297,"Sean Raubenheimer","Community House",1274,16,9,7,56.3
191,"Norman Visagie",Steenberg,1273,10,5,5,50.0
198,"Dillan Godfrey",UCT,1272,14,8,6,57.1
537,"Alex O'Ryan",Goodwood,1272,10,6,4,60.0
295,"Marc Petersen","Community House",1270,14,6,8,42.9
390,"Ghalieb Davids",Nexus,1270,14,6,8,42.9
175,"Yaaseen Manuel","MP Royals",1269,14,4,10,28.6
302,"Tiago Faria","Community House",1268,14,6,8,42.9
217,"Darren Wyngaardt","Bishop Lavis",1267,10,2,8,20.0
536,"Abrie Cronje",Goodwood,1267,8,6,2,75.0
145,"Craig Zimri","MP Royals",1264,12,6,6,50.0
871,"Samuel Ilori",Lenasia,1263,8,6,2,75.0
238,"Latino Palmer","Bishop Lavis",1260,10,5,5,50.0
286,"Dirk Coetzee","Community House",1260,18,7,11,38.9
487,"Errol Joemath",Duinefontein,1260,14,5,9,35.7
257,"Timothy Lingeveldt",Boundary,1259,8,5,3,62.5
285,"Ashley Tsai","Community House",1259,10,5,5,50.0
421,"Ezra Msindeni",Ravens,1256,12,3,9,25.0
292,"Janine Sait","Community House",1255,16,8,8,50.0
571,"Sedick Alexander",Stephanians,1253,12,6,6,50.0
163,"Ilyaaz Patel","MP Royals",1251,12,6,6,50.0
563,"Kirk Daries",Stephanians,1250,12,5,7,41.7
113,"Shaun Francis",Top,1249,12,5,7,41.7
338,"Martin Jansen",Liv-Ken,1247,10,3,7,30.0
159,"David Cyfers","MP Royals",1244,14,7,7,50.0
94,"Merlin Brown",Top,1243,14,3,11,21.4
334,"Kian Jansen",DLPE,1243,12,7,5,58.3
476,"Adam Domingo",Duinefontein,1243,10,5,5,50.0
700,"Bradley Benting",Boundary,1242,10,2,8,20.0
349,"Kian Chapman",Liv-Ken,1241,14,4,10,28.6
541,"Brendan O'Connell",Goodwood,1239,14,6,8,42.9
945,"Vic Carrasco","Tempe Military",1239,8,5,3,62.5
190,"William Prinsloo",Steenberg,1238,12,5,7,41.7
346,"Christian Poggenpoel",Liv-Ken,1233,8,3,5,37.5
380,"Sameer Parker",Nexus,1232,10,6,4,60.0
538,"Andre Taljaard",Goodwood,1232,14,7,7,50.0
326,"Ikraam Francis","Community House",1231,10,6,4,60.0
671,"Seraaj Omar",Stephanians,1231,10,6,4,60.0
116,"Andries Steenkamp",Top,1229,8,5,3,62.5
153,"Andre Johnson","MP Royals",1229,10,3,7,30.0
309,"Jason Albertyn","Community House",1229,10,5,5,50.0
425,"Richard Ntamutumba",Ravens,1229,14,5,9,35.7
555,"Shakeel Hendricks",Goodwood,1229,14,6,8,42.9
893,"Villyen Motaze",Masters,1229,8,5,3,62.5
374,"Yaseen Toefy",Nexus,1228,10,3,7,30.0
553,"Richard Abrahams",Goodwood,1226,14,4,10,28.6
57,"Liqhawe Pepeta",CPUT,1223,12,6,6,50.0
158,"Joel Martin","MP Royals",1222,10,3,7,30.0
328,"Milo Katz","Community House",1219,14,7,7,50.0
384,"Rafiek Tofa",Nexus,1216,12,4,8,33.3
97,"Lorenzo Haupt",Top,1214,12,2,10,16.7
287,"Ebrahiem Effendi","Community House",1214,16,6,10,37.5
400,"Rob de Villiers",Protea,1210,14,6,8,42.9
575,"Aden Buckton",Stephanians,1210,14,6,8,42.9
199,"Liam Olsen",UCT,1209,12,5,7,41.7
684,"Faseeq Davids",Stephanians,1209,10,5,5,50.0
419,"Darren Orr",Ravens,1207,14,2,12,14.3
535,"Tazmin Harris",Duinefontein,1206,8,3,5,37.5
602,"Mark Collison",Stephanians,1206,10,4,6,40.0
96,"Richard Fitzgibbon",Top,1204,14,4,10,28.6
682,"Gamza Taliep",Stephanians,1204,8,4,4,50.0
221,"Henry Esau","Bishop Lavis",1203,14,2,12,14.3
261,"Zondre Adams",Boundary,1203,12,5,7,41.7
293,"John Busch","Community House",1203,14,4,10,28.6
385,"Kamiel Ebrahim",Nexus,1201,10,3,7,30.0
681,"Tashreeq Samsodien",Stephanians,1201,8,4,4,50.0
110,"David Esau",Top,1196,14,3,11,21.4
109,"Moses Baartman",Top,1195,14,3,11,21.4
504,"Mekhail Schroeder",Duinefontein,1193,12,1,11,8.3
551,"Pedro Fortuin",Goodwood,1193,14,4,10,28.6
418,"Bevan Steyn",Ravens,1190,14,3,11,21.4
353,"Nahum Philander",Liv-Ken,1189,14,4,10,28.6
569,"Junaid Fredricks",Stephanians,1188,12,4,8,33.3
7,"Gajen Chetty",Maties,1187,11,5,6,45.5
89,"Stanford Nomdo",Top,1187,8,2,6,25.0
543,"Charl Grobbelaar",Goodwood,1187,14,4,10,28.6
301,"Thomas Parker","Community House",1182,12,3,9,25.0
472,"Garth Greybe",Duinefontein,1181,10,3,7,30.0
310,"Shane Fortuin","Community House",1175,12,4,8,33.3
5,"Cetin Celik",Maties,1173,18,7,11,38.9
132,"Xavier Williams",Top,1172,8,2,6,25.0
223,"Chesray Booysen","Bishop Lavis",1171,16,2,14,12.5
262,"Tayla Bailey",Boundary,1170,14,2,12,14.3
389,"Cashief Mowzer",Nexus,1168,14,4,10,28.6
162,"Munier Patel","MP Royals",1166,10,3,7,30.0
210,"Siyanda Ntlali",UWC,1166,10,4,6,40.0
222,"Thabiet Adams","Bishop Lavis",1162,20,4,16,20.0
331,"Atlaaf Solomons",DLPE,1162,14,5,9,35.7
307,"Hitendra Makan","Community House",1154,8,2,6,25.0
234,"Rhiyaan Cupido","Bishop Lavis",1153,14,4,10,28.6
549,"Lester Malgas",Goodwood,1153,8,3,5,37.5
90,"Stanley Nomdo",Top,1147,8,0,8,0.0
696,"Craig Pasqualie","Community House",1147,10,0,10,0.0
107,"Quentin Thomas",Top,1145,14,1,13,7.1
546,"Delton Alexander",Goodwood,1144,14,2,12,14.3
167,"Tyrone Van De Merwe","MP Royals",1139,10,3,7,30.0
68,"Chloe Hendricks",Top,1138,14,1,13,7.1
290,"Fayzal Galant","Community House",1137,14,4,10,28.6
288,"Ebrahim Scello","Community House",1132,8,1,7,12.5
394,"Rick Solomons",Nexus,1131,12,3,9,25.0
229,"Kyle Sebo","Bishop Lavis",1130,10,0,10,0.0
275,"Abdul Ismail","Community House",1128,10,2,8,20.0
670,"Aneekah Sauls",Stephanians,1124,10,3,7,30.0
237,"Brandon De Jager","Bishop Lavis",1121,14,0,14,0.0
554,"Salie Petersen",Goodwood,1121,10,2,8,20.0
444,"Jordan Martin",Ravens,1116,8,0,8,0.0
63,"Donovan Smith",Top,1113,8,0,8,0.0
70,"Xoey Williams",Top,1107,12,1,11,8.3
318,"Martin Bacchus","Community House",1104,14,3,11,21.4
69,"Shiloh Smith",Top,1101,14,2,12,14.3
13,"Joel Joshua",Maties,1100,8,1,7,12.5
383,"Jawaad Schippers",Nexus,1097,14,1,13,7.1
548,"Enrico Louw",Goodwood,1091,10,1,9,10.0
66,"Jessica Adams",Top,1082,12,0,12,0.0
427,"Aiden Oransie",Ravens,1075,14,1,13,7.1
92,"Jay Nomdo",Top,1069,12,0,12,0.0
212,"Siphelele Mkhetho",UWC,1064,12,1,11,8.3
317,"Josh Idesis","Community House",1051,10,0,10,0.0
